***X***********X***X*
XX*X*XXXXX*XXX*X*X*X*
***X*X***X***X***X***
*XXX*X*X*XXX*XXXXXXX*
*X***X*X***X*X*****X*
*X*XXX*XXX*X*X*XXX*X*
*X*****X*X*X*****X*X*
*XXXXXXX*X*XXXXXXX*XX
*X***********X***X***
*XXXXXXXXXXXXX*X*XXX*
***X***X*******X*****
XX*X*X*X*XXXXXXXXXXX*
*X***X*X***X*****X*X*
*XXXXX*X*X*X*X*X*X*X*
***X*X*X*X*X*X*X***X*
*X*X*X*XXX*X*X*XXXXX*
*X***X*****X*X*******
*XXXXXXXXXXX*XXXXXXXX
*******X***X***X***X*
*XXX*XXX*X*XXX*X*X*X*
***X*****X*******X***