***X***X*****X*****X
XX*X*X*XXXXX*X*X*X*X
*****X***X***X*X***X
*XX**XXX*X*XXX*XXX*X
*****X***X*****X***X
XXXXXX*XXX*XXXXX*X*X
*****X*****X*****X*X
*XXXXXXX*X*X*XXX*XXX
*******X*X*X*X*****X
*XXXXX*X***X*X**XX*X
*X***X***X*X***X***X
*X*X*XX***XXXXX**X*X
*****************X*X
*XXXXXXX*X*XXXXXXX*X
*X*****X*X***X***X*X
*X**XX*XXX*X*X*X*X*X
*X*****X*****X*X***X
*XXX*X*X*XXX*X*XXXXX
*****X***X*********X
XXXXXXXXXX*XXXXXXX**