*X*****X*******X*****X*********X*X*******X*****************X*******X*****X*********X***********X***X
*X*XXXXX*XXX*X*XXX*X*X*XXXXXXX*X*X*XXX*XXX*XXXX**X***XXXXX*X*XXXXX*X*X*X*X***XXXXX*XXXX**XX*XX*X*X*X
*X*******X***X*****X*******X***X*****X*********X*******X*X***X***X*X*X*X*******X*****X***X***X*X*X*X
*X*XX*XXXX*XXXX*X*XXXXXX*XXX*XXX*XXXXXXXXXXXXXXXXXXXXX*X*XXXXXXX*X**XX*X*XXXX**XXXXX*X*XXX*XXX*XX**X
*X***X*****X*****X*********X*X***X*******X***********X***********X***********X***X***X*X***X***X***X
*XXX*X*XXX*X*XXXXX*XXX*XXX*X**XXXX*XXX*X*X*XXXXXXX***X*X**XX*XXX*XXXXXXXXXXX*XXX*X*XX**X*X*X*XXX***X
***X*X***X*X*************X*********X***X***X***********X***X*X*X*X*********X*****X*X***X*X***X***X*X
*X*X*XXX*X*XXX*XXX*XXX*XXXXXXXXXXXXX*X*XXXXXXXXXXXXXXX*XXXXX*X*X*X**X**XX*XXXXXX*X*X*XXX*XXXXX*XXX*X
***X*****X***X*******X*******X*******X*X***********X*****X***X***X***X*********X***X*X*X*X*******X*X
****XXX**XXX*XXX*XXX*XXX*XXX*X*XXXXXXX*X*XX***XXXX*XXX*X*X*XXX*XXXXX*XXXX*XX*X*X*XXX*X*X*XXXXXXX*XXX
*******X***X***X***X*****X***X*X*****X***X*************X***X*X*****X*****X***X*X*X***X*X*******X***X
XXXXXX*X*X*XXX*X*X*XXXXXXX*XXX*X*XXX*XXXXXXXXX*X*XX**XXXXXXX*XXXXX*X**XXX**XXX*X*X***X*XX*XXXX*XXX*X
*****X*******X*X*******X*X***X*X*******X*******X***X*****X*****X***X*******X*X*X*X*X*********X*****X
*X*XXXXX*X*XXX*XXXXXX**X*XXX*X*X*XXX*X*XXX*XXX*XXX*XXXXX*X***X*X**XXXX*XX*XX*X*X*X*X*X*XXXXXXXXXXX*X
*X*****X*X*X***************X*********X***X***X***X***X*****X***X*X*****X***X***X*****X*X*********X**
*XXX*XXX**XX*X*X*X***X*XXXXX*XXXXXXXX*XX*XXX*XXXXXXX*X*XXXXX*XXX*X****XX*X*X****XXXXXX*X*XXXXXXX*X*X
*X*X***X*X***X***X***X*X*****X*****X*****X***X*******X*****X*****X*X*X***X*X*X*******X***********X*X
*X*X***X*X*XXXXXXXX*XX*X*X*XXX*XXX*XXXXX***X*X*XXXXXXX*XXX*XXX*X*XXX*X*X**XX***XXXXX*X*XXX*X***XX**X
***X***X*X*************X*******X*X*****X***X*X*X***X*****X***X*X*****X*X***X*X*X***X*X***X*X*X*****X
XX*X***X*XXXXXXX*XXXXXXX*XXXXX*X*XXXXX*X*XXXXX*X*X*XXXX**XXX*X*XXXXX*X*XXX*X*X*X*X*X*XXX*XXX*X*X*XXX
***X*****X***************X*******X***X*X*X***X***X***X*****X*X*****X*****X*X*X***X*X***X*******X***X
*XXXXXXXXX*XXXXX*X***XXXXX*X*XXX*X*X*X*X*X*X***XXXXX*X*XXX*X*X*XXX*X*X*X*X*X*XXXXX*XX**XX*XXXX*X*XXX
*X*****X*******X*X***X*X***X***X***X*X*X*X*X*********X***X***X*X***X***X*X*X*X*********X*****X*X***X
*X*XX**X*XXXXX*X*XXXX**X*XXX*X*XXXXX*X*XXX*XXX*XXXXXXX*X*X*XXX*X*X*XXX*X*X*X*X****XXXX*XXXXX*X*XXX*X
***X*X*X*X*****X*******X*****X***X*********X***X*****X*X*X*****X*X***X***X*X***X***X*X***X***X******
XXXX*X*XXX*XX*XX*X*XXX*XXXXX*XXX*X*X*X*XXXXX*X*X***XX**X*XXXXX*X*XXX*XXX*X*XXXXX*X*X*XXX*X*X*XXX*X*X
*X***X*X***X***X***X***X*****X*********X*****X*X***X***X*****X*X*X*X*X***X*******X*****X*******X***X
*X*X*X***XXX**XXXX*X*X*X*XXXXX*XXXXXXX*X*X*XXX*X*X*X*XXXX*XX*X*X*X*X*X**XXXXXX*XXXXXXXXXXX*X*XX**XXX
***X*X*X*X*X***X***X*X*X*X***X*X***X***X*X*X*X*X*X*X*X***X***X*X*X*X***X*X***X***************X***X*X
*XXX*X*X*X*X*X*X*XXX*XXX*XXX*X*X*XXX**X*XX*X*X*X*X*X*X***X*XXX*X*X*XXXXX*X*X*XXX*XXXXXXX*XXXX**XXX*X
*X*X***X*X***X***X*X***X*****X*X*X*********X*****X*X*X*X*X*X***X***X***X***X***X*******X*****X*X***X
*X*XXXXX*X*XXX*X*X*XXX*XXX**XX*X***XXXXXX*XXXXXXXX*X*X*X***X*X*XXX***XXX**XXXX*X*X*XXX*X*XXXXX*XXX*X
*****X***X***X*X*X***X*********X***X*****************X*X*X***X***X*X*******X***X***X***X*****X******
XXXX*XXX*XXX*X*X*X*X**XXXXXX*XX**XXX*XXXXXX*XXXXXXXXXXXX*X**XXX**X**XXXXXXXX*XXX*X*X*XXX*XXX*XXXX**X
***X*****X*X*X***X*****X***X*X*****X***X*************X***X*****X*X***X*******X***X*X*X***X*X*****X*X
*X*XXXXXXX*X*XXXXXXX*X***X*X*XXXXX*XXX*X*XXXXX*XXXX**X*XXXX*XX*X*XXX*X*XXXXX*X*X*X*X***XXX*X*XXXXX*X
*X*X*******X*X*****X*X***X*X***X*****X*X*******X***X*******X***X*****X*****X*X*X***X***X***X*******X
*XXX*X*X*XX**X*XXX*X*XXXXX*XXX*X*X*XXX*XXX*XX**X*XXX*XXX*X*X*XXX*XXXXXXX*X*X*X*X*X*XXXXXXX*XXXXXXXXX
*******X*X***X*X*X*X*****X***X*****X***X*X*X*******X*******X*X*****X***X*X*X*X*X*X*******X*********X
*XXXXXXX***XXX*X*X*XXXX*XX*X*XXXXX*X*XXX***X*XXX*X*XXX*X*X*X*XXX*X*X***X*X*X*X***XX**XXX*XXXXX**X**X
*****X***X*****X*X*******X*X*****X***X***X*X***X*X***X***X*X*****X***X*X*X*X*X*****X***X*****X*X*X*X
XX**XX*XXXXXXXXX*XXX***X*X*X*XXXXXXXXX*XX**X*X*X*XXX***X***XXX*X*XX*XX*XXX*X*XX*XX*XXX*XXXXX*X*X*X*X
***X***X*************X*X*X*X*X***X*******X*X*******X***X***X***X*****X***********X*****X***X***X*X*X
*X*X*X*X*X*XXXXXXXXXXX*X*X*X*X***X*XXXXX*X*****XXX*XXXX***XX*X*XXXXX*XXX*X*XXXXX*XX*XXX*X**XX*XX*X*X
*X*X*X*X*******X*******X*X*****X*X*X*******X***X***********X*X***X***X***X***X*****X*********X*****X
*X*X*XXXXX*X*X**X*XXXX*X*X*XXXXX*X**XX*XXXXX***XXXXXXXXXXX*X*XXXXX*XXX*XXXX*XX*X*XXX*XXX***XXX*XXXX*
***X*********X*********X*X*X*****X***X*****X*X***X*******X***X***X*X*X*******X*X*X*****X*X*X***X***X
*XXX*XX**XXXXXXXXXXX*XXX*XXX*X*X*XXX*X*X*X*X*XXX***XXXXX*XXXXX*X*X*X*XX*XXXX*X*X*X*XXXXX*X*X*X*XXX*X
*X***X*X*****X*****X***X***X*****X***X***X*X***X***************X*X***X*******X*X*X*X*X***X*X*X******
*X*X*X*XXX*XXX*X*X**XX*X*X*X*XXX*X*XXX*X*X*XXX*XXXXXXX*X*X*X*XXX***X***XXXXXXX*XXX*X*X*XXX***XX**X*X
***X*****X*****X*X***X*****X***X*X*******X***X*****X*******X***X***X*X*X*******X***X*X***X*X***X*X*X
XXXX*X*XXXXX*XXX*XXX*XXX*X*X*X*XXXXXXXXXX*X**X*XXX*X*XXXXX*XXX*XXXXX*X***XXXXX*X*XXX*XXX*XXXXX*X*X*X
***X***X***X***X*X*X*X***X*X*X*******X***X***X***X***X***X*X*X*X*****X*X*******X*******X*****X***X*X
*XXX*XXX*X*XXXXX*X*X*X*XXX*XXXXX*X*X*X*X*X*XXX*X*XXX*X*X*X*X*X*XXX*XXX*X*XXX*XX*XX*XXX*XXXXX*XX*X**X
*****X*X*X***X***X*X*X*X***X*****X*X***X*X*X***X***X*X***X*X*****X*******X***X***********X***X***X*X
XXXX*X*X*XXX*X*XXX*X*X*X*XXX*X*X*X*XXXXXXX*XXXXX*X*X*X*XX**X*XXX*XXXXXXXXX*XXX*XXXXXXXXXXX*X*XXX*X*X
***X***X*X*****X*******X*****X*X*X*********X*****X*X*X*********X*X*************X*****X*****X*******X
***XX*XX*X**XXXX*XXXXX**XXXX*X***X*XXXXXXX*X*XXX*X*X*XXXX*XXXX*X*X*X*XXXXXXXXXXX*XXXXX*XXXXXXX*XXX*X
*X*****X*X*X*****X***X***X***X*X*************X*****X*****X*****X***X*******X*********X***X***X*X***X
*XXXXX*X*X***XXXXX*X*X*X*X*X*X**XXXXXXX*XX*XXXXX*X*XXX*X*XXXXX**X*XX*XXXXX*XXXXXXX*X*XXX*X*X*X*X*XXX
*****X***X***X*****X***X*X*X*X*********X***X***X*X***X***************X***X***X***X*****X*X*X***X***X
XXXX**XXXX*XXX*XXXXX*X*X*X*X*XXXX*X*XX*X*XXX*X*XXX***X*XXXXXXXXX*XXXXX*XXX*X*X*X*XXX*X*X*X*X*XXX*X*X
***X*X*****X*X*X*****X*X***X*********X*X*X***X*****X*X*X***X*****X*********X***X*****X***X*X*****X*X
*X*X*X*XXXXX*X*X***XXX*X*X*XXXXX*X*X*X*XXX*XXX*XXXXX*X*XXX*X*XXXXX*X*XXXXX*XXXXXX*XXXX*X*X*XXX*X*X*X
*X*X*X***X***X*X*****X***X*X*******X***X***********X*X*****X***X*****X*X*************X*X***X*X*X*X*X
*X*X**XX*X**XX*X*X*X*X*XXX*X*X***XXXXXXX**XX*XXX*XXX*XX*XX*XXX*X*XXXXX*X**XXXX*X*XXX*X*XXXXX*X*XX**X
*X***X*****X***X*X*X*X*X***X*X***X***X***X***X***X***X*******X*X*****X*X*X*****X***X*X*******X*****X
*XXXXX*XXXX**X***X*X*X*X*XXXXX***X*X*X*X**XX*XXXXX*XXXXXXXXX*X*XXX*X*X***X*XXXXX*X*X*X*X**XX*XXXXXXX
*******X*******X***X***X*********X*X*********X*****X*****X*****X*******X*X*X***X***X*X*X***X***X***X
*XXX***X*XX*XX**XX*XXXXX*X*X*XXXXX**X****X*X***XX*XX*X*X***XXX*XXXX*XXXX*X*X*X*X*XXX*X*XXX*XXX*XXX*X
***X*X***X*******X***X***X*********X***X***X*****X***X*X*****X*****X*****X***X*******X*****X*X*****X
XXXX*XXX*XXXX**X*X*X*X*XXXXXXXXX*XXX*X*X*XX*XXXX*XXXXX*X*XXXXXXXXX***XXX*X*XXXXX*X*XXXXXXXXX*XXXXX**
*****X*******X*X***X*X*********X***X*X*X*X*****X*X*****************X*X***X***X***X******************
*XXXXX*XXXXX*X*XXXXX*X*XXXXXXX*XXX*X*X*X*X*XXX*X****XXXXXXXXXXX*XXXX*X*X*X*X*X*XXXXXXX*XX*XXXXXX*X*X
*******X***X*X*****X*********X*****X*X*X***X***X***X*************X***X*****X*X*****X*X*********X*X*X
XX*X*XX****X*XXX*X*X*XXX*XXXXXXX*XXX*X*XXX*X*XXXXXXX*XXX*X*XXXXX*X*XXXXX**XXX*X*XX*X*XXXXX**XX**XX*X
***X***X*X*X***X*X*X*X*X*********X***X***X***X*****************X*X*X***X*X*****X***X*****X*X***X***X
*XXX*XXX*X*XXX*XXX*X*X*X***XXXXXXX*XXXXX*X*XXXX*XX***XXX*X*XXXXX***X*X*XXX*XXX*X*XXX*X*X*XXX**XX*XXX
*X*******X***X***X*X*X***X*X*************X*****X***X***X*X***X***X*X*X*****X***X*******X*X***X***X*X
*X*XXX*XXXXX*XX**X*X*XX**X*XXXXX*XXX*XXXXX*XXX*X*X*XXX*XXXXX*X*XX**X*X*XXXXX*XXXXXXX*X***X*X*X*XXX*X
***X*******X*X*****X***X*X***********X***X*X*X*X*X*****X*****X*X*************X*******X*X***X*X*X***X
XX*X*XXX*X*X*XXXXXXXXX**XXXXXXXX*X*XXX*X*X*X*X*X*XXX*XXX*XXXXX*X**XXXXXX*X*X*X*XXXXXXX*XXXXXXX*XXX*X
***X*X*****X*******X***X*****X*****X***********X***X*****X*****X***X***X*X*X*X*X*****X*********X***X
*X*X*X*XXX*XXXXX*X*X*XXX*XXX*X*XXXXX*X***XXXXX*X*X*XXXXX***XXXXXX**X*X*X*X*XXX*X*XXX*XXXX*XXXXXX*X**
*X***X***X*X*****X*X*X***X***X*******X***X*****X*X*X*****X*****X***X*X*X*X*X***X*************X***X*X
*XXXXXX**X*X*XXX*X*X*X**XX*X*XXXXX*X*XX*XX**XXXX*X*X*XXXXXXXXX*X*XXX*X*XXX*X*XXX*XXXXXXX*X*X*XX**X*X
***X*****X*****X*X*X*X***X*X***X*X*X*X***X*X*****X*X*******X***X***X*******X*X*X***X*****X*X***X*X*X
XX*X*X*XXXXXXX*X*X*X*XXX*X*XXX*X*X*XXX*X*X*X*XXXXX*XXXXX*XXX*XXXXXXX*X*XXXXX*X*XXX*X*X*XXX*X***X**XX
***X*******X***X*******X*X***X***X*X***X*********X*X***X*X***X*******X*X*****X*******X*X*****X*X***X
*XX**XXXX*XX*X*X**XXXX*X*X*X*X**XX***XXXXX*X*XXX*X*X*X*X*X**XX*XXXXXXXXX*XXXXX***XXXXXXX*XXX*X*XXX*X
*****X***************X*X***X*X*X***X*X*****X*X***X***X*X*X*X***X*****X***X*******X*****X*X*******X*X
X**X*X*X*X*XXXXXXXXX*XXXXX*X*XX**XXX*X*X*XXX*X*X*XXXXX*X*X*X*XXX*XXX*X*XXXXX**X**X*XX**X*XXX*XXX*X**
***X*X*X***X***X***********X***X*X***X*X***X***X*X***X*X***X*X*******X***X*****X***X***X***X*X***X*X
*XXXXX*XXXXXXX*X*XXXXX*XXXXXXX*X*X**XX**XX*XX*XX*X*XXX***XXX*X**X**X*XXX*X*XXX*XXXXX*XXX*X***X*XX**X
*X***X*X*******X*X*****X*X***X*X*X*X***X*******X***X*********X***X*****X*X*X*******X*X*****X*X*****X
***X*X*XXXXX*XXX*X*XXXXX*X*X*X*X*X*X*XX**XXXX**XXX*X*XXXXXXX*XXX*XXX*XXX*X*XXXXXX**X****X**X*XXXXX*X
***X*X*X***X*****X*X*******X***X*X*X***X*X***X***X*X*******X*******X*****X*******X***X*X***X*******X
*X*X*X*X***X*X*XXX*X*XXX*X**XXXX*X*XXX*X***X*XXXXX*X*X*X*X*XXXXXXX**XXXXX*XXXXX****XXXXX*XX***XXXX*X
***X*****X***X*******X***X*************X***X*********X***X***********************X*******X*********X
XXXXXX***XXXXXXX*XXX*XXXXXXXXXXX*XXXXXXXXXXXXX*XXXXX**XXXXXXXXXXXXXXXX*XXXXXXX**XX*XXXX**XXXXXXXX***
