*X*X*******
*X*X*XXXXX*
*X*****X***
*XXXXXXX*X*
*********X*
XXXXXXXXXX*
*X*********
*X*XXXXXXXX
*X***X***X*
*XXX*X*X*X*
*******X***