***********
XXXXXXXXXX*
*******X***
XX*X*XXX*XX
***X*X***X*
*XXX*X*XXX*
*X***X*X***
*XXXXX*X*X*
*****X*X*X*
*XXX*X*XXX*
***X*******